111110000000000
000010000000000
000010000000000
000000000000000
000000000000000
000010000000000
000010000000000
000010000000000
111110000000000
000000000000000
000000000000000
000000000000000
000000000000000
000000000011110
000000000000000
000000000000000
000000000000000
000000001111000
000000000000000
000000000000000