000010000000000
000010000000000
000010000000000
000010000000000
111110000000000
000000000000000
000000000000000
111110000000000
000010000000000
000010000000000
000010000000000
000010000000000
000000000000000
000000000000000
000000011100000
000000000000000
000000000111000
000000000000000
000000000000000
000000000000000