000000011000000
000000010000000
000000010000000
000000000000000
000000000000001
000000000000000
000001000000000
000001000010000
000001000011000
000000000011000
000000000000000
000000000000000
001000000000000
010000010000111
100000010000001
000000010000000
000000100000000
000000100010000
000000100010000
000000000010000
