000000000000000
000000000000000
000000010000000
000000000000000
000000000000000
000000000001110
111111000000000
000000000100000
000100000000000
000100000010000
000000000000000
000000000000000
000000000000000
000001110000000
000000000000000
000000000001110
000100000000000
000000010000000
000000000000000
000000000000000
