000000001000000
000000000000000
000000000000000
000000000000001
000100010000000
111100001000000
000000000100000
000000000010000
000000000010000
000100000000000
111100000000001
000000000000001
000000000000000
000000000000000
000001111110000
000000000000000
000000000000000
000000010000000
000000010000000
000000010000000